wwwwwwwwwwwwwwwwwwww
w----b--b--b--b----w
w---wwwbw--wbwww---w
w---w---b---b--w---w
w-www-b--bb--b--ww-w
w-b-b--w-ww-w--b-b-w
w-b----w-ww-w--b-b-w
w-www-b--b---b-www-w
w---w--b----b--w---w
w---wwwbw--wbwww---w
w-b--b--b--b--b--b-w
wwwwwwwwwwwwwwwwwwww
18 1
15 1
15 4
8 5
1 9
5 5
7 1
17 9
9 10
10 3